1111111111111111111111111111111111111111111111111111111111
1M00000000000000000000000000000000000000000000000000000001
1000000000000000000000000000000000000000000000000000000001
1000000000000000000000000000000000000000000000000000000001
1000000000000000000000000000000000000000000000000000000001
1000011111110000111111100011111110M1111111110M0M0M0M0M0MM1
1000011111110000111111100011111110M111111111M0M0M0M0M0MM11
1000000000110000000001100000000110M0M0M00110M0M0M0M0M0MM11
1P0000000011000011111110001111111000M0M011M0M0M0M0M0M000E1
1000000000110000000001100000000110M0000110M0M0M0M0M0M0MM11
1000000000110000111111100011111110M0M011M0M0M0M0M0M0M0MM11
1000000000110000111111100011111110M00110M0M0M0M0M0M0M0MM11
10000000000000000000000000000000CCCCCCCC00000M000000000001
10000000000000000000000000000000000000000000MC000000000001
100000000000000000000000000000000000000000000M000000000001
1000000000000000001100000000000011000011000000000000000001
1111111111111111111111111111111111111111111111111111111111