1111111111111111111
1CC00010000000CCCC1
1C101101011101C11C1
1C1C101M00C101CM1C1
1C111C1M011101CE1C1
1CCCCC00P00001CC1M1
1111111111111111111