1111111
1010111
1CP11E1
1000001
1111111